0
0
4
450 100 0
550 100 0
450 900 1
550 900 1
2
890 110 0
110 890 1
1
12
4
0 0 1000 0 1000 100 0 100
4
1000 0 1000 1000 900 1000 900 0
4
1000 1000 0 1000 0 900 1000 900
4
1000 0 0 0 100 0 100 1000
4
900 350 900 400 650 400 650 350
4
100 600 450 600 450 650 100 650
4
750 600 750 650 650 650 650 600
4
250 350 350 350 400 350 250 400
3
650 400 650 350 600 300
3
350 400 350 350 400 300
3
650 650 650 600 600 700
3
350 650 350 600 400 700